1111111111111111111111111
1000000000001000000000001
1011101111101011111011101
1000000000000000000000001
1011101101111111011011101
1000001100001000011000001
1111101111101011111011111
1111101100000000011011111
1111101101111111011011111
0000000001111111000000000
1111101100000000011011111
1111101101111111011011111
1000000000001000000000001
1011101111101011111011101
1001100000000000000011001
1101101110111110111011011
1000001110001000111000001
1011111111101011111111101
1000000000000000000000001
1111111111111111111111111
