1111111111111111111111111
1000000000001000000000001
1311101111101011111011131
1000000000000000000000001
1011101101111111011011101
1000001100001000011000001
1111101111121211111011111
1111101122222222211011111
1111101121111111211011111
0000002221111111222000000
1111101122222222211011111
1111101121111111211011111
1000000000001000000000001
1011101111101011111011101
1301100000000000000011031
1101101110111110111011011
1000001110001000111000001
1011111111101011111111101
1000000000000000000000001
1111111111111111111111111
